1111111111111
1E0CP01000011
1111111111111
