1111111111111111111111111111111111
1P0000000000100C00000C000000000001
11G0101001010001010010000G00101011
10100100101010100010010000G0010101
1E0000000C0000000000000000000000C1
1111111111111111111111111111111111
