1111111111111111111111111111111111
1E00G0000000000C0G000C000000000001
101001010G100000101001000000010101
10100100101010100G1001000000010101
1P0000000C00C0000000000000000000C1
1111111111111111111111111111111111
